1111111111111111111111111111111111111111111111111111111111
1P00000011111111111111110000001111111111110000000000000001
111000000011111111111111000M000111111111110000M000M0000001
1100000000111111111111110000000011111111111000000000000001
1100M00000111111111111110000000011111111111000M000M0000001
1100000000011111111111110000M00011111111111000000000000001
11110011100M1111111111110000000011111111111000M0000M000001
1111001111001111111111110000M00011111111111000000000000001
11110011110M111111111111000000001111111111110000M000M00001
111100111100000000000000M000000M11111111111000000000000001
1111M0111111110M0000M000000M0M00000000000000M0000000000001
111100111111110000M00000000M000M11111111111100000000000001
11110011111111000000000M00000001111111111110000000C00000E1
111100111111110000000M000000M00011111111111100000C00000001
11110011111111000M000000M000000011111111111110000C00000001
11110M11111111000000M000000M000011111111111110000C00000001
1111001111111111111111111111111111111111111111111111111111
1111111111111111111111111111111111111111111111111111111111
