1111111111111111111111111111111111111111111111111111111111
1P00000011111111111111110000001111111111110000000000000001
111000C00011111111111111000M000111111111110000M000M0000001
11000000C0111111111111110000000011111111111000000000000001
1100M00000000000000000000000000000000000000000M000M0000001
1100000000011111111111110000M0001111111111100000000000CE01
1111111111111111111111111111111111111111111111111111111111
