1111111111111111111111111111111111111111
100000000000000000E00000000000000C000001
1000000000000000000000000000000000000001
100000000000000000000C000000000000000001
1000000000000000001111111111111111111111
1000000000000000001111111111111111111111
1111111101111110000000000000011111111111
1111111101111111C00000000000011111111111
1111111101111111111111111100111111111111
11111111M1111111111111111100111111111111
11111111C1111111111111111100111111111111
1111111101111111111111111001111111111111
1111111101111111111111111100111111111111
111111110111111111111111110M111111111111
1111111101111111111111111100111111111111
1111111100000000000000000000000000000001
1000000000000000000000000000000000111111
1111100000000000000000000000000000000001
1111111111111111111C0000000000000P111111
1111111111111111111111111111111111111111
