111111111111111111111111111111111111111111111111111111111111111111111111111111111111111111111111111111111111111111
11000000C0111111111111110000000011111111111000000000000001000C00011111111111111000M000111111111110000M000M00000011
1100M00000000000000000000000000000000000000000M000M00000011000C00011111111111111000M000111111111110000000000000001
11000P0000011111111111110000M0001111111111100000000000C0011000C00011111111111111000M000111111111110000M000M0000001
111000C00000000000000000000000000000000000000000000000000000000000000000000000000000000000000000000000M000M0000001
11000000C01111111111111100000000111111111110000000000000011000C00011111111111111000M000111111111110000M000M0000001
11000000C0111111111111110000000011111111111000000000000001000C00011111111111111000M000111111111110000M000M00000011
1100M00000000000000000000000000000000000000000M000M00000011000C00011111111111111000M000111111111110000000000000001
1100000000011111111111110000M0001111111111100000000000C0011000C00011111111111111000M000111111111110000M000M0000001
111000C00000000000000000000000000000000000000000000000000000000000000000000000000000000000000000000000M000M0000001
11000000C01111111111111100000000111111111110000000000000011000C00011111111111111000M000111111111110000M000M00E0001
11000000C0111111111111110000000011111111111000000000000001000C00011111111111111000M000111111111110000M000M00000011
1100M00000000000000000000000000000000000000000M000M00000011000C00011111111111111000M000111111111110000000000000001
1100000000011111111111110000M0001111111111100000000000C0011000C00011111111111111000M000111111111110000M000M0000001
111000C00000000000000000000000000000000000000000000000000000000000000000000000000000000000000000000000M000M0000001
11000000C01111111111111100000000111111111110000000000000011000C00011111111111111000M000111111111110000M000M0000001
11000000C0111111111111110000000011111111111000000000000001000C00011111111111111000M000111111111110000M000M00000011
1100M00000000000000000000000000000000000000000M000M00000011000C00011111111111111000M000111111111110000000000000001
1100000000011111111111110000M0001111111111100000000000C0011000C00011111111111111000M000111111111110000M000M0000001
111000C00000000000000000000000000000000000000000000000000000000000000000000000000000000000000000000000M000M0000001
11000000C01111111111111100000000111111111110000000000000011000C00011111111111111000M000111111111110000M000M0000001
11000000C0111111111111110000000011111111111000000000000001000C00011111111111111000M000111111111110000M000M00000011
1100M00000000000000000000000000000000000000000M000M00000011000C00011111111111111000M000111111111110000000000000001
1100000000011111111111110000M0001111111111100000000000C0011000C00011111111111111000M000111111111110000M000M0000001
111000C00000000000000000000000000000000000000000000000000000000000000000000000000000000000000000000000M000M0000001
11000000C01111111111111100000000111111111110000000000000011000C00011111111111111000M000111111111110000M000M0000001
11000000C0111111111111110000000011111111111000000000000001000C00011111111111111000M000111111111110000M000M00000011
1100M00000000000000000000000000000000000000000M000M00000011000C00011111111111111000M000111111111110000000000000001
1100000000011111111111110000M0001111111111100000000000C0011000C00011111111111111000M000111111111110000M000M0000001
111000C00000000000000000000000000000000000000000000000000000000000000000000000000000000000000000000000M000M0000001
11000000C01111111111111100000000111111111110000000000000011000C00011111111111111000M000111111111110000M000M0000001
11000000C0111111111111110000000011111111111000000000000001000C00011111111111111000M000111111111110000M000M00000011
1100M00000000000000000000000000000000000000000M000M00000011000C00011111111111111000M000111111111110000000000000001
1100000000011111111111110000M0001111111111100000000000C0011000C00011111111111111000M000111111111110000M000M0000001
111000C00000000000000000000000000000000000000000000000000000000000000000000000000000000000000000000000M000M0000001
11000000C01111111111111100000000111111111110000000000000011000C00011111111111111000M000111111111110000M000M0000001
11000000C0111111111111110000000011111111111000000000000001000C00011111111111111000M000111111111110000M000M00000011
1100M00000000000000000000000000000000000000000M000M00000011000C00011111111111111000M000111111111110000000000000001
1100000000011111111111110000M0001111111111100000000000C0011000C00011111111111111000M000111111111110000M000M0000001
111000C00000000000000000000000000000000000000000000000000000000000000000000000000000000000000000000000M000M0000001
11000000C01111111111111100000000111111111110000000000000011000C00011111111111111000M000111111111110000M000M0000001
111111111111111111111111111111111111111111111111111111111111111111111111111111111111111111111111111111111111111111
