11111111
10000EC1
11111011
1P0000C1
11101111
100000C1
10M11001
100001C1
11111111
