11111111
10000EC1
11111011
1P000EC1
11101111
10000EC1
11111011
10000EC1
11111111
