1111111111111111
1CCCM0E111000001
1CPM00011100E001
1C0C00M111000001
1111111111111111
